ПО - Tarkvara -TA
Процесс разработки ПО - Tarkvara arendusprotsess
Документация на ПО - Tarkvara dukumentatsioon
Проект - Projekt
ИТ проект - IT projekt
Бизнес-проект - Äriprojekt
Проект по разработке - Аrendusprojekt
Проект по реализации - realiseerimisprojekt
Диаграмма Ганта - Gantti diagramm
***Lisa esimese faili juurde järgmised tõlked:

?критический путь проекта -projekti kriitiline tee
?виды рисков в проекте - projekti riskiliigid
?аутсортсинг --allhanke 
?краудсортсинг -- rahvahanke 
?ИТ аудит -- IT audiit
?ERP системы -- ERP süsteemid
?ROI для оценки проектов -- ROI projekti hindamiseks
?Tacit susteemid Tacit
?Knowledge Managment System KMS -?
?cистемы управления базами данных – какие знаете? andmebaaside haldususteemid MS SQL, Orecle, MS Acess  
?Project Managment Tool ? Projecti haldamisetarkvara MS Project, ProjectLibre

mudel - модель
kasutusmalliskeem - Прецедентов диограмма/схема
tegevusskeem - Диограмма активности / деятельности 
jadaskeem - Диограмма последовательностей
klassiskeem - Диограмма классов
koostööskeem - Диограмма взаимодействий  
andmebaasiskeem - Диограмма баз данных
olem - сущность
seos - связь
muster -узор
mustand - черновик
punkt - точка
romb - ромб
ristkülik - прямоугольник
nool - стрелка
joon - линия
algussõlm - начальный узел
ovaal - овал
